222222222222222222222222000000000002222222222222222222222222
233333333333333333333333351111111153333333333333333333333332
232222222222222222222222241111111142222222222222222222222232
232222222222222222222222241111111142222222222222222222222232
232222222222222222222222200005500002222222222222222222222232
232222222222222222222222222223322222222222222222222222222232
232222222222222222222222222223322222222222222222222222222232
232222222222222222222000000005500000000222222222222222222232
232222222222222222222411111111111111114222222222222222222232
232222222222222222222411111111111111114222222222222222222232
232222222222222222222411111111111111114222222222222222222232
232222222222222222222411111111111111114222222222222222222232
232222222222222222222411111111111111114222222222222222222232
232222222222222222222411111111111111114222222222222222222232
232222222222222222222000000005500000000222222222222222222232
232222222222222222222222222223322222222222222222222222222232
232222222222222222222222222223322222222222222222222222222232
232222222222222222222222222223322222222222222222222222222232
232222222222222222222222222223322222222222222222222222222232
232222222222222222222222222223322222222222222222222222222232
232222222222222222222222222223322222222222222222222222222232
232222222222222222222222000005500000222222222222222222222232
232222222222222222222222411111111114222222222222222222222232
232222222222222222222222411111111114222222222222222222222232
232222222222222222222222411111111114222222222222222222222232
233333333333333333333333511111111115333333333333333333333332
222222222222222222222222411111111114222222222222222222222222
222222222222222222222222411111111114222222222222222222222222
222222222222222222222222411111111114222222222222222222222222
222222222222222222222222000000000000222222222222222222222222