222222222222222222222222222222222222222222222222222222222222
222222222222222222222222222222222222222222222222222222222222
000000000022222222222222222222222222222222222222222222222222
411111111533333333333222222222222222222222222222222222222222
411111111422222222223333322222222222222222222222222222222222
411111111422222222222222322222222222222222222222222222222222
411111111422222222222222322222222222222222222222222222222222
000000000022222222222222322222222222222222222222222222222222
222222222222222222222222322222222222222222222222222222222222
222222222222222222222222322222222222222222222222222222222222
222222222222222222222222322222222222222222222222222322222222
222222222222222222222200500000000002222222222222222322222222
222222222222222222222241111111111142222222222200000502222222
222222222222222222222241111111111153332222222241111142222222
222222222222222222222241111111111142232222222241111142222222
222222222222222222222241111111111142233333333351111142222222
222222222222222222222241111111111142222222222241111142222222
222222222222222222222205000000000002222222222200000002222222
222222222222222222222223222222222222222222222222222222222222
222222222222222222222223333333333222222222222222222222222222
222222222222222222222222222222223222222222222222222222222222
222222222222222222222222222000005000022220000022222222222222
222222222222222222222222222411111111422224111422222222222222
222222222222222222222222222411111111422335111533333333333333
222222222222222222222222222411111111533320000022222222222222
222222222222222222222222222411111111422222222222222222222222
222222222222222222222222222411111111422222222222222222222222
222222222222222222222222222411111111422222222222222222222222
222222222222222222222222222000000000022222222222222222222222
222222222222222222222222222222222222222222222222222222222222

