222222222222222222222222222222222222222222222222222222222222
222222222222222222222000000000000222222222220000000000000022
222222222222222222222411111111114222222222224111111111111422
222222222223333333333511111111115333333322224111111111111422
222222222223222222222000000000000222222322224111111111111422
222222222223222222222222222222222222222333335111111111111422
222222222223222222222222222222222222222222224111111111111422
222222222223222222222222222222222222222222220000000050000022
222222222223222222222222222222222222222222222222222232222222
222222222223222222222222222222222222222222222222222233222222
222222222223222222222222222222222222222222222222222223222222
222222222223222222222222222222222222222222222222222223222222
220000000005000022222222222222222222222222222222222223222222
224111111111111422222222222222222222222222222222222223222222
224111111111111422222222222222222222222222222222000005000222
224111111111111422222222222222222222222222222222411111114222
224111111111111422222222222222222222222222222222411111114222
220000000000005022222222222222222222222222222222000005000222
222222222222223222222222222222222222222222222222222223222222
222222223333333222222222222222222222222222222222222223333222
222222223222222222222222222222222222222222222222222222223222
222222223222222222222222222222222222222222222222222222223222
222222223222222222222222222222222222222222222222222222223222
220000005002222222222222222222222222222222222222222222005022
224111111142222222222222222222222222222222222222222222411422
224111111142222222222222222222222222222333333333333333511422
224111111153333333333333333333333333333322222222222222000022
220000000002222222222222222222222222222222222222222222222222
222222222222222222222222222222222222222222222222222222222222
222222222222222222222222222222222222222222222222222222222222

