222222222222222222222222222222222222222222222222222222222222
222222222222222222222222222222222222222222222222222222222222
222222222222222222222222222222222222222220000002222222222222
222222222222222222222222222222000002222224111142222222222222
222222222222222222222222222222411142222335111153333333333333
222222222222222222222222222222411153333320000002222222222222
222222222222222222222222222222000502222222222222222222222222
222222222222222222222222222222222322222222222222222222222222
222222222222222222222222222222222322222222222222222222222222
222222222222222222222222222222222332222222222222222222222222
222222222222222222222222222222222232222222222222222222222222
222222222222222222222222222222222232222222222222222222222222
000000000022222222222222222222222232222222222222222222222222
411111111422222222222222222222222232222222222222222222222222
411111111533333333332222222222000050002222222222222222222222
411111111422222222232222222222411111142222222222222222222222
005000000022222222233333333333511111153333222222222222222222
223222222222222222222222222222000000002223333322222222222222
223222222222222222222222222222222222222222222322222222222222
223333333322222222222222222222222222222222222322222222222222
222222222322222222222222222222222222222222222332222222222222
222222222322222222222222222222222222222222222232222222222222
222222222322222222222222222222222222222222222232222222222222
220000000502222222222222222222222222222222222232222222222222
224111111142222222222222222222222222222222222050000222222222
224111111142222222222222222222222222222222222411114222222222
224111111142222222222222222222222222222222222411114222222222
220000000002222222222222222222222222222222222411114222222222
222222222222222222222222222222222222222222222000000222222222
222222222222222222222222222222222222222222222222222222222222

