222222222222222222222000000000022222222222222222222222222222
222222222222222222222411111111422222222222222222222222222222
220000000000000002222411111111422222222222222222222222222222
224111111111111142233511111111422222222222222222222222222222
224111111111111153332411111111422222222222222222222222222222
220005000000000002222411111111422222222222222222222222222222
222223222222222222222000000000022222222222222222222222222222
222223222222222222222222222222222222222222222222222222222222
222223333322222222222222222222222222222222222222222222222222
222222222322222222222222222222222222222222222222222222222222
222222220500002222222200000000022222222222222222222222222222
222222224111142222222241111111422222222222222222222222222222
222222224111153333333351111111422222222222222222222222222222
222222224111142222222200005000022222222222222222222222222222
222222224111142222222222223222222222222222222222222222222222
222222220000002222222222223222222222222222222222222222222222
222222222222222222222222223222222222222222222222222222222222
222222222222222222222222223333322222222222222222222222222222
222222222222222222222222222222322222222222222222222222222222
222222222222222222222222222222322222222222222222222222222222
222222222222222222222222222222322222222222200000022222222222
222222222222222222222222222222322222222333351111533333333333
222222222222222222222222222220500000022322241111422222222222
222222222222222222222222222224111111533322200000022222222222
222222222222222222222222222224111111422222222222222222222222
222222222222222222222222222220000000022222222222222222222222
222222222222222222222222222222222222222222222222222222222222
222222222222222222222222222222222222222222222222222222222222
222222222222222222222222222222222222222222222222222222222222
222222222222222222222222222222222222222222222222222222222222