222222222200000002222222222222222222222222222222222222222222
222222222241111142222222222222222222222222000000002222222222
222222222241111142222222222222222222222222411111142222222222
222222222241111142222222222222222222222222411111142222222222
222222222241111142222222222222222222222222411111153333333333
222222222241111142222222222222222222222222000050002222222222
222222222205000002222222222222222222222222222232222222222222
222222222223222222222222222222222222222222222232222222222222
222222222223222222222222222222222222222222222232222222222222
222233333333222222222222222222222222222222222232222222222222
222232222222222222222222222222222222222222222232222222222222
222050000222222222222222222222222222222222223332222222222222
222411115333333333332222222222222222222222223222222222222222
222411114222222222232200002222222222222222223222222222222222
222000050222222222232241142222222222222222223222222222222222
222222232222222222232241153333332222222222223222222222222222
222222232222222222233351142222233333333333333322222222222222
222222232222222222222200002222222222222222222322222222222222
222222232222222222222222222222222222222222222322222222222222
222222233322222222222222222222222222222222222322222222222222
222222222322222222222222222222222222222222222332222222222222
222222222322222222222222222222222222222222222232222222222222
222222222322222222222222222222222222222222222232222222222222
222222000500000002222222222222222222222222200050022222222222
222222411111111142222222222222222222222222241111422222222222
222222411111111142222222222222222222222222241111422222222222
222222411111111142222222222222222222222222241111422222222222
222222000000000002222222222222222222222222200000022222222222
222222222222222222222222222222222222222222222222222222222222
222222222222222222222222222222222222222222222222222222222222