222222222222222222222222222220000002222222222222222000000002
222222222222222222222222222224111142222222222222222411111142
222222222222222222222222222224111142222222222222222411111142
222222222222222222222222222224111142222222222222222411111142
222222222222222222222222222224111142222222222222222411111142
222222222222222222222222222224111142222222222222222050000002
222222222222222222222222222224111142222222222222222232222222
222222222222222222222222222220005002222222222222222232222222
222222222222222222222222222222223222222222222222222232222222
222222222222222222222222222222233222222222222222222233333322
222222222222222222222222222222232222222222222222222222222322
222222000000000022222222222222232222222222220000000000000502
222222411111111422222222222222232222222333335111111111111142
222222411111111422222222222220050002222322224111111111111142
222222411111111422233333333335111153333322224111111111111142
222222411111111533332222222224111142222222224111111111111142
222222411111111422222222222220000502222222220000000050000002
222222000050000022222222222222222322222222222222222232222222
222222222232222222222222222222222322222222222222222232222222
222222222232222222222222222222222322222222222222222232222222
222222222222222222222222222222222222222222222222223332222222
222222222222222222222222222222222222222222222222223222222222
222222222222222222222222222222222222222222222222005002222222
222222222222222222222222222222222222222222222222411142222222
222222222222222222222222222222222222222222222222411142222222
222222222222222222222222222222222222222222222222411142222222
222222222222222222222222222222222222222233333333511142222222
222222222222222222222222222222222222222222222222000002222222
222222222222222222222222222222222222222222222222222222222222
222222222222222222222222222222222222222222222222222222222222