200000000000002222222222222222222222222222222222222222222222
241111111111142222222222222222222222222222222222222222222222
241111111111142222222222222222222222222222222222222222222222
205000000000002222222222222222222222222222222222222222222222
223222222222222222222222222222222222222222222222222222222222
223222222222222222222222222222222222222222222222222222222222
223222222222222222222222222222222222222222222222222222222222
223222222222222222222222222222222222222222222222222222222222
223222222222222222222222222222222222222222222222222222222222
223222222222222222222222222222222222222222222222222222222222
223333333322222222222222222222222222222222222222222222222222
222222222322222222222222222222222222222222222222222222222222
222222222322222222222222222222222222222222222222222222222222
222222222322222222222222222220000000222222222222222222222222
222222222322222222222222222224111114222222222222222222222222
222222222333333333332222222224111114222222222222222222222222
222222222322222222233333333335111114222222222222222222222222
222222222322222222222222222220000000222222222222222222222222
222222333322222222222222222222222222222222222222222222222222
222222322222222222222222222222222222222222222222222222222222
222222322222222222222222222222222222222222222222222222222222
200000500000000002222220000000000022222222222000000000000002
241111111111111153332224111111111422222222222411111111111142
241111111111111142232224111111111422222233333511111111111142
241111111111111142232224111111111422222232222411111111111142
200000000000000002233335111111111422222232222411111111111153
222222222222222222222224111111111533333332222000000000000002
222222222222222222222224111111111422222222222222222222222222
222222222222222222222220000000000022222222222222222222222222
222222222222222222222222222222222222222222222222222222222222