222220000000000022222222222222222222222222222222222222222222
222224111111111422222222222222222222222222200000000000000002
222224111111111533333333333333333222222222241111111111111142
222220000000000022222222222222223333333333351111111111111142
222222222222222222222222222222222222222222200000000500000002
222222222222222222222222222222222222222222222222222322222222
222222222222222222222222222222222222222222222222222322222222
222222222222222222222222222222222222222222222222222322222222
222222222222222222222222222222222222222222222222222322222222
222222222222222222222222222222222222222222222222333322222222
222222222222222222222222222222222222222222222222322222222222
222222222222222222222222222222222222222222222222322220000022
222222222222222222222222222222222222222222222222322224111422
222222222222222222222222222222222222222222222222333335111533
222222222222222222222222222222222222222222222222222224111422
222222222222222222222222222222222222222222222222222220000022
222222222222222222222222222222222222222222222222222222222222
222222222222222222222222222222222222222222222222222222222222
222222222222222222222222222222222222222222222222222222222222
222222222222222222222222222222222222222222222222222222222222
222222222222222222222222222222222222222222222222222222222222
222222222222222222222222222222222222222222222222222222222222
222222222222222222222222222222222222222222222222222222222222
222222222222222222222222222222222222222222222222222222222222
222222222222222222222222222222222222222222222222222222222222
222222222222222222222222222222222222222222222222222222222222
222222222222222222222222222222222222222222222222222222222222
222222222222222222222222222222222222222222222222222222222222
222222222222222222222222222222222222222222222222222222222222
222222222222222222222222222222222222222222222222222222222222