222222222222222222222222222222222222222222222222222222222222
222222222222222222222222222222222222222222222222222222222222
222222222222222222222222222222222222222222222222222222222222
222222222222222222222222222222222222222222222222222222222222
222222222222222222222222222222222222222222222222222222222222
222222222222222222222222222222222222222222222222222222222222
222222222222222222222222222222222222222222222222222222222222
222222222222222222222222222222222222222222222222222222222222
222222222222222222222222222222222222222222222222222222222222
222222222222222222222222000000000000222222222222222222222222
222222222222222222222222411111111114222222222222222222222222
222222222222222222222222411111111114222222222222222222222222
222222222222222222222222411111111114222222222222222222222222
222222222222222222222222411111111114222222222222222222222222
222222222222222222222222411111111114222222222222222222222222
222222222222222222222222411111111114222222222222222222222222
222222222222222222222222411111111114222222222222222222222222
222222222222222222222222411111111114222222222222222222222222
222222222222222222222222411111111114222222222222222222222222
222222222222222222222222411111111114222222222222222222222222
222222222222222222222222000000000000222222222222222222222222
222222222222222222222222222222222222222222222222222222222222
222222222222222222222222222222222222222222222222222222222222
222222222222222222222222222222222222222222222222222222222222
222222222222222222222222222222222222222222222222222222222222
222222222222222222222222222222222222222222222222222222222222
222222222222222222222222222222222222222222222222222222222222
222222222222222222222222222222222222222222222222222222222222
222222222222222222222222222222222222222222222222222222222222
222222222222222222222222222222222222222222222222222222222222