222222222222222222222222222222222222222222222222222222222222
222222222222222222222222000000000000002222222222222222222222
222222222222222222222222411111111111142222222222200000000222
222222222222222222222222411111111111142222222222241111115333
222222222222222222222222411111111111142333333333351111114222
222222222222222222222222411111111111153322222222241111114222
222222222222222222222222411111111111142222222222200000000222
222222222222222222222222000005000000002222222222222222222222
222222222222222222222222222223222222222222222222222222222222
222222222222222222222222222223333332222222222222222222222222
222222222222222222222222222222222232222222222222222222222222
000000000002222222222222222222222232222222222222222222222222
411111111142222222222222222222222232222222222222222222222222
411111111142222222222222222222220050002222222222222222222222
411111111142222222222222222222224111142222222222222222222222
411111111153333333333333333333335111142222222222222222222222
000050000002222222222222222222220005002222222222222222222222
222232222222222222222222222222222223222222222222222222222222
222232222222222222222222222222222223222222222222222222222222
222232222222222222222222233333333333222222222222222222222222
222232222222222222222222232222222222222222222222222222222222
222232222222222222223333332222222222222222222222222222222222
222232222222222222223222232222222222222222222222222222222222
222233333333333333333220050022222222222222222222222222222222
222222222222222222222224111422222222222222220000022222222222
222222222222222222222224111422222222222333335111422222222222
222222222222222222222224111533333333333322224111422222222222
222222222222222222222220000022222222222222220000022222222222
222222222222222222222222222222222222222222222222222222222222
222222222222222222222222222222222222222222222222222222222222